##################################E#############################################
#                                                               #              #
#                                                               #              #
#                                                               #              #
#              B             B               B                  #              #
#                                                               #              #
#                                                               #              #
#                                                               #              #
#                                                               #              #
#                                                               #              #
#                                                               #              #
#                                                               ################
#                                                               #              #
#                                                               #              #
#                                                               #              #
#                                                               #              #
#                                                               #              #
#                                                               #              #
#                                                               #              #
#                                                               #              #
#                                                               #              #
#                                                               #              #
#                                                               #              #
#                                                               #              #
#                                                               #              #
#                                                               #              #
#                                                               #              #
#                                                               #              #
#                                                               #              #
#                                                               #              #
#                                                               #              #
#                                                               #              #
#                                                               #              #
#                                                               #              #
#                                                               #              #
#                                                               #              #
#                                                               #              #
#                                                               #              #
#                                                               #              #
#                              L                                #              #
#                                                               #              #
################################################################################