##################################E#############################################
#                                                               #              #
#                                                               #              #
#                                                               #              #
#              [                 [                 [            #              #
#                                                               #              #
#                                                               #              #
#                                                               #              #
#                                                               #              #
#                                                               #              #
#                                                               #              #
#                                                               ################
#                                                               #              #
#                                                               #              #
#                                                               #              #
#                                                               #              #
#                                                               #              #
#                                                               #              #
#                                                               #              #
#                                                               #              #
#                                                               #              #
#                                                               #              #
#                                                               #              #
#                                                               #              #
#                                                               #              #
#                                                               #              #
#                                                               #              #
#                                                               #              #
#                                                               #              #
#                                                               #              #
#                                                               #              #
#                                                               #              #
#                                                               #              #
#                                                               #              #
#                                                               #              #
#                                                               #              #
#                                                               #              #
#                                                               #              #
#                                                               #              #
#                              *                                #              #
#                                                               #              #
################################################################################