###############################################################################
#              #        #                                       #
#              #    $   #                              L        #
#              #######  #                                       #
#   $                                                           #
#                 M                                             ###############
#                                                               #
#                                                               #
#                                                               #
#                                             M                 #
#                                                               #
#                                                               #
#                                                               #
E                                                               #
#                                  $                            #
###############################################################################
