###############################################################################
#   L          #        #
#              #    $   #
#              #######  #
#
#                 M
#
#                                                                     $
#
#                                             M
#
#
#                   $
#
#                                       $
#
#
###############################################################################
